5552 5863 5394 3451 0952 9883 0785 5425 4803 7747
0286 4006 8307 1651 9733 7470 2796 1318 6333 4779
5418 9002 5521 3863 3469 5507 0382 1219 5440 8657
5701 7076 9213 5615 8954 3582 8695 6770 1364 7526
5886 5321 4133 3183 9259 4416 6327 6824 7390 8870
1882 2410 3673 3530 9850 2999 7542 3418 3330 2020
8522 5320 3830 2269 4013 2919 9162 0662 6729 8294
7187 6900 8109 4855 9365 5232 9962 2801 5228 9796
4265 4994 8669 5549 5246 9456 6822 9612 2394 5815
7088 6366 4329 5433 9374 6600 5680 1738 0987 2148
