2041 6626 3318 3125 2987 9195 0482 8819 7966 6976
1130 8971 3063 9082 4318 4733 8366 8526 9241 2778
0884 8162 8318 9368 0950 2659 5294 7090 4026 3358
4188 8105 7174 1995 1621 9260 0373 1156 0956 7252
5003 5251 5472 6972 0916 1811 4537 4338 8475 3667
7999 0130 0817 2297 5980 1329 1231 4446 0713 8896
8998 4909 4252 8521 6747 2033 3403 1419 8487 7103
8524 9535 1835 6701 4328 7888 8485 1907 6670 5053
7742 9186 8055 3200 1663 6941 4298 2947 7894 0814
9237 2872 8832 5284 8279 6200 2441 7464 5505 4766
